DC (eng) - deccan chronicles (Done)
HB (hin) - hari bhumi (Done)
HT (eng) - hindustan times(no html content,paid)
KM (kan) - karnataka malla (Done)
LH (hin) - live hindustan(incomplete html content , paid)
MC (mar) - mumbai chaufer (Done)
MM (kan) - Mysuru Mithra (Done,doesn't work in server but works in localhost , kan)
NBT (hin) - nav bharat times (Done)
NGS (guj) - nav gujrat samay(Done)
NHT (eng) - nav hind times(done)
NT (tel) - namaste telangana(incomplete html content , telgu)
OHO (eng) - o herald o(done)
PAP (hin) - purvanchal prahari(Done)
PBK (hin) - prabhat khabar(Done)
PRM (ori) - Prameya(incomplete html content , odissa)
PRJ (kan) - Prajavani(paid)
PUD (mar) - pudhari(numbers in marathi)
SAK (tel) - sakshi(incomplete html content,telgu)
SBP (ben) - sangbad pratidin(Done)
SKE(eng) - sikkim express 
SKL(mar) - sakal(numbers in marathi)
SMJ (ori) - Samaja(Done)
SOM (kan) - Star of Mysore(done)
SY (kan) - Samyuktha(Done)
TB (eng) - the tribune(classified only on sunday)
TH (eng) - the hindu(incomplete html content , paid)
UV (kan) - Udayavani(paid)
VV (kan) - Vijayavani(Done)
YB (hin) - yasho bhumi(Done)
NYB - niyomiya barta(Done)
nai dunia- (Done)
Kannada Prabha - (seperate pic and text images) 
Kerala Kaumudi - (single edition, no ads)
lokmat - (Done)
loksatta - (incomplete html content, different text and pic images)
midday- (no html content)
Nava Bharat - (Done)
Nava rashtra - (Done)
Orissa Bhaskar - (no ads)
Rajasthan Patrika - ( diff pageid per page and edition)
sandesh - (incomplete html content)
sanmarg- (incomplete html content)
Siasat Daily(urd) - (incomplete html content , blank images)
Statesman(mostly obituary ads) - seperate pic and text images , incomplete html content
Suryaa - no ads
Telangana Today - (incomplete html content)
Telegraph - single edition
Tripura Observer - (incomplete html content)
The Pioneer - pdf epaper
vaartha - (no ads)
Janpath Samachar - (Done)
Jansatta - (different pic and text images)
Mizoram Post - (pdf)
Pratidin odia daily - (Done)
Rashtriya Sahara - (Done)
sambad = (done)